1111111111111111111111
1000001000000000000001
100P001011110000000001
10001111E0000000000001
1000100C111100C000C001
100C100111110011100001
100000010101001000C001
1000000100010011100001
100C0000C000C0000C0001
1000000000000000000001
1111111111111111111111